7777766666666666
7777766666666666
7777726666666666
2222222222222222
4444444462362362
4444444462362362
4444444462362362
4444444462362362
4444444462362362
4444444462362362
4444444462362362
4444444462362362
4444444462362362
4444444462362362
4444444462362362
4444444462362362